tilesetIso.png 7 57 113
15 15
1	1	3	3	3	3	3	3	3	3 3 3 3 3 3
3	1	1	1	1	3	3	3	3	3 3 3 3 3 3
3	3	1	1	1	1	1	3	3	3 3 3 3 3 3
3	3	1	1	1	1	1	1	1	3 3 3 3 3 3
3	3	1	1	1	1	1	1	1	3 3 3 3 3 3
3	1	1	1	1	1	1	3	3	3 3 3 3 3 3
3	1	1	1	1	1	1	1	3	3 3 3 3 3 3
3	3	1	1	1	1	1	1	3	3 3 3 3 3 3
3	3	1	1	1	1	1	1	1	1 3 3 3 3 3
3	3	3	3	3	1	3	3	1	1 1 3 3 3 3
3	3	3	3	3	1	3	3	3	1 1 3 3 3 3
3	3	3	3	3	1	1	1	1	1 1 3 3 3 3
3	3	3	3	3	3	3	3	3	1 1 1 1 3 3
3	3	3	3	3	3	3	3	3	3 3 1 1 3 3
3	3	3	3	3	3	3	3	3	3 3 1 1 1 1